000000000000000
011110001102220
011111111100020
000001111111020
022201111111110
022200000011110
022011111011110
022011111000110
000110111022010
011100111022010
011010111022010
010111111010110
022011111011010
022011111011110
022011111011110
000000000000000
